11111111111111111111111
1P000000000000000C00011
1000000000000000000E001
11111111111111111111111